NO ./textures/placeholder.xpm
SO ./textures/placeholder1.xpm
WE ./textures/placeholder2.xpm
EA ./textures/placeholder3.xpm
DC ./textures/dplaceholder.xpm
DO ./textures/oplaceholder.xpm
F 0,0,0
C 255,255,50

111111111111111111111111111111111
100001000000000000000000000000001
10S001000011001111110000011100011
100001010011001000010000001110001
100001000000000011110000001110001
111D11000000000000000000000000001
100001111111101101111111111111111
101100000000101000100011111100101
101100000000101000000001111001001
101100000001000100000000110010001
101100000000000000100000000100001
111111111111111111111111111111111