NO ./textures/placeholder.xpm
SO ./textures/placeholder1.xpm
WE ./textures/placeholder2.xpm
EA ./textures/placeholder3.xpm
F 255,0,0
C 100,30,255

111111
100001
10E001
100001
100001
100001
100001
100001
100001
100001
100001
111111