NO ./textures/placeholder.xpm
SO ./textures/placeholder1.xpm
WE ./textures/placeholder2.xpm
EA ./textures/placeholder3.xpm
F 0,0,0
C 255,255,50


1111111111111111111111111
1000000000110000000000001
1011000001110000000000001
100100000000000000000000111111111
111111111011000001110000000000001
100000000011000001110111110111111111111
111101111111110111000000100010000000001
111101111111110111010100100010111111101
110000001101010111000000100010000100001
100000000000000011000000100010000100001
100000000000000011010100100000000100001
11000001110101011111011110N010000100001
111101111111010111011110100010111111101
111111111111111111111111111110000000001
111111111111111111111111111111111111111